14 8
##############
#............#
#............#
#....bb......#
#.....g......#
#..g..g..r.r.#
##############
##############
