14 8
##############
#............#
#............#
#......r.....#
#......##....#
#..g.....r.b.#
##b###g.######
##############
