14 8
##############
#............#
#............#
#......r..r..#
#......##rrr.#
#..g.....r.b.#
##b###g.######
##############
